###b################b######
#      d     a            #
#      #     #            #
##########b######a## ###d##
#c     #mm mmm#    # ammmm#
b      d      a    d #mmmm#
#      #mmm mm#  c # #mmmm#
####a###### #b#  ### ### ##
#c       c#              c#
#      #  #      #mmmmmmmm#
########b##################